1 13 31
###############################
#p    s**    1 * 2 *  * * *   #
# # # #*# # #*#*# # # #*#*#*# #
#  x*     ***  *  1   * 2 * * #
# # # # # #*# # #*#*# # # # #*#
#f     b   * **  *  *   1     #
# # # # # # # # # #*# #*# # # #
#*  *  b   *  *  s   *   s    #
# # # # #*# # # #*#*# # # # # #
#*    **  *  s   *    f       #
# #*# # # # # # #*# # # # # # #
#     f     *   *  *         b#
###############################
