1 13 31
###############################
#p    s**    1 * 2 *  * * *   #
# # # #*# # #*#*# # # #*#*#*# #
#  x*     ***  *  1   * 2 * * #
# # # # # #*# # #*#*# # # # #*#
#f     b   * **  *  *   1     #
# # # # # # # # # #*# #*# # # #
#*  *  b   *  *  s   *  2s    #
# # # # #*# # # #*#*# # # # # #
#*    **  *  s   *    f  2    #
# #*# # # # # # #*# # # # # # #
#     f     *   *  *  1      b#
###############################
