1 13 31
###############################
#p    s**    1 * 2 *  * * *   #
# # # #*# # #*#*# # # #*#*#*# #
#  x*     ***  *  1#  * 2 * * #
# # # # # #*# # #*#*# # # # #*#
#f  3  b   * **  *  *   1     #
# # # # # # # # # #*# #*# # # #
#*  *  f   *  *  s # *  2s    #
# # # # #*# # # #*#*# # # # # #
#*    **  *  s f *    f  2    #
# #*# # # # # # #*# # # # # # #
#     s     *   *  *  1      b#
###############################