1 13 31
###############################
#p     ** *  1 * 2 *  * * *   #
# # # #*# # #*#*# # # #*#*#*# #
#  x*     ***  *  1   * 2 * * #
# # # # # #*# # #*#*# # # # #*#
#f     b   x **  *  *   1     #
# # # # # # # # # #*# #*# # # #
#*  *  b   *  *  s   *   s    #
# # # # #*# # # #*#*# # # # # #
#*    **  *  s   *    f       #
# #*# # # # # # #*# # # # # # #
#     f     *   *  *         b#
###############################
