1 13 31
###############################
#p    s** #  1 * 2 *  * * * 3 #
# # # #*# # #*#*# # # #*#*#*# #
#  x*  3  ***  *  1#  * 2 * * #
# # # # # #*# # #*#*# # # # #*#
#f  3  b   * **  *  *   1     #
# # # # # # # # # #*# #*# # # #
#*  *  f#  *  *  s # *  2s    #
# # # # #*# # # #*#*# # # # # #
#* 3  **  *  s f *    f  2    #
# #*# # # # # # #*# # # # # # #
#     s  3  *   *  *  1  *   3#
###############################